0.0 0.1
0.0 2.5
103
1.0 -5.000000 25.000000 0.0 0.0 1
1.0 -4.900000 24.010000 0.0 0.0 1
1.0 -4.800000 23.040000 0.0 0.0 1
1.0 -4.700000 22.090000 0.0 0.0 1
1.0 -4.600000 21.160000 0.0 0.0 1
1.0 -4.500000 20.250000 0.0 0.0 1
1.0 -4.400000 19.360000 0.0 0.0 1
1.0 -4.300000 18.490000 0.0 0.0 1
1.0 -4.200000 17.640000 0.0 0.0 1
1.0 -4.100000 16.810000 0.0 0.0 1
1.0 -4.000000 16.000000 0.0 0.0 1
1.0 -3.900000 15.210000 0.0 0.0 1
1.0 -3.800000 14.440000 0.0 0.0 1
1.0 -3.700000 13.690000 0.0 0.0 1
1.0 -3.600000 12.960000 0.0 0.0 1
1.0 -3.500000 12.250000 0.0 0.0 1
1.0 -3.400000 11.560000 0.0 0.0 1
1.0 -3.300000 10.890000 0.0 0.0 1
1.0 -3.200000 10.240000 0.0 0.0 1
1.0 -3.100000 9.610000 0.0 0.0 1
1.0 -3.000000 9.000000 0.0 0.0 1
1.0 -2.900000 8.410000 0.0 0.0 1
1.0 -2.800000 7.840000 0.0 0.0 1
1.0 -2.700000 7.290000 0.0 0.0 1
1.0 -2.600000 6.760000 0.0 0.0 1
1.0 -2.500000 6.250000 0.0 0.0 1
1.0 -2.400000 5.760000 0.0 0.0 1
1.0 -2.300000 5.290000 0.0 0.0 1
1.0 -2.200000 4.840000 0.0 0.0 1
1.0 -2.100000 4.410000 0.0 0.0 1
1.0 -2.000000 4.000000 0.0 0.0 1
1.0 -1.900000 3.610000 0.0 0.0 1
1.0 -1.800000 3.240000 0.0 0.0 1
1.0 -1.700000 2.890000 0.0 0.0 1
1.0 -1.600000 2.560000 0.0 0.0 1
1.0 -1.500000 2.250000 0.0 0.0 1
1.0 -1.400000 1.960000 0.0 0.0 1
1.0 -1.300000 1.690000 0.0 0.0 1
1.0 -1.200000 1.440000 0.0 0.0 1
1.0 -1.100000 1.210000 0.0 0.0 1
1.0 -1.000000 1.000000 0.0 0.0 1
1.0 -0.900000 0.810000 0.0 0.0 1
1.0 -0.800000 0.640000 0.0 0.0 1
1.0 -0.700000 0.490000 0.0 0.0 1
1.0 -0.600000 0.360000 0.0 0.0 1
1.0 -0.500000 0.250000 0.0 0.0 1
1.0 -0.400000 0.160000 0.0 0.0 1
1.0 -0.300000 0.090000 0.0 0.0 1
1.0 -0.200000 0.040000 0.0 0.0 1
1.0 -0.100000 0.010000 0.0 0.0 1
1.0 0.000000 0.000000 0.0 0.0 1
1.0 0.100000 0.010000 0.0 0.0 1
1.0 0.200000 0.040000 0.0 0.0 1
1.0 0.300000 0.090000 0.0 0.0 1
1.0 0.400000 0.160000 0.0 0.0 1
1.0 0.500000 0.250000 0.0 0.0 1
1.0 0.600000 0.360000 0.0 0.0 1
1.0 0.700000 0.490000 0.0 0.0 1
1.0 0.800000 0.640000 0.0 0.0 1
1.0 0.900000 0.810000 0.0 0.0 1
1.0 1.000000 1.000000 0.0 0.0 1
1.0 1.100000 1.210000 0.0 0.0 1
1.0 1.200000 1.440000 0.0 0.0 1
1.0 1.300000 1.690000 0.0 0.0 1
1.0 1.400000 1.960000 0.0 0.0 1
1.0 1.500000 2.250000 0.0 0.0 1
1.0 1.600000 2.560000 0.0 0.0 1
1.0 1.700000 2.890000 0.0 0.0 1
1.0 1.800000 3.240000 0.0 0.0 1
1.0 1.900000 3.610000 0.0 0.0 1
1.0 2.000000 4.000000 0.0 0.0 1
1.0 2.100000 4.410000 0.0 0.0 1
1.0 2.200000 4.840000 0.0 0.0 1
1.0 2.300000 5.290000 0.0 0.0 1
1.0 2.400000 5.760000 0.0 0.0 1
1.0 2.500000 6.250000 0.0 0.0 1
1.0 2.600000 6.760000 0.0 0.0 1
1.0 2.700000 7.290000 0.0 0.0 1
1.0 2.800000 7.840000 0.0 0.0 1
1.0 2.900000 8.410000 0.0 0.0 1
1.0 3.000000 9.000000 0.0 0.0 1
1.0 3.100000 9.610000 0.0 0.0 1
1.0 3.200000 10.240000 0.0 0.0 1
1.0 3.300000 10.890000 0.0 0.0 1
1.0 3.400000 11.560000 0.0 0.0 1
1.0 3.500000 12.250000 0.0 0.0 1
1.0 3.600000 12.960000 0.0 0.0 1
1.0 3.700000 13.690000 0.0 0.0 1
1.0 3.800000 14.440000 0.0 0.0 1
1.0 3.900000 15.210000 0.0 0.0 1
1.0 4.000000 16.000000 0.0 0.0 1
1.0 4.100000 16.810000 0.0 0.0 1
1.0 4.200000 17.640000 0.0 0.0 1
1.0 4.300000 18.490000 0.0 0.0 1
1.0 4.400000 19.360000 0.0 0.0 1
1.0 4.500000 20.250000 0.0 0.0 1
1.0 4.600000 21.160000 0.0 0.0 1
1.0 4.700000 22.090000 0.0 0.0 1
1.0 4.800000 23.040000 0.0 0.0 1
1.0 4.900000 24.010000 0.0 0.0 1
1.0 5.000000 25.000000 0.0 0.0 1
1.0 -0.2 2.46 0.0 0.0 1
1.0 0.2 2.46 0.0 0.0 1
101
0 1 1 0
1 2 1 0
2 3 1 0
3 4 1 0
4 5 1 0
5 6 1 0
6 7 1 0
7 8 1 0
8 9 1 0
9 10 1 0
10 11 1 0
11 12 1 0
12 13 1 0
13 14 1 0
14 15 1 0
15 16 1 0
16 17 1 0
17 18 1 0
18 19 1 0
19 20 1 0
20 21 1 0
21 22 1 0
22 23 1 0
23 24 1 0
24 25 1 0
25 26 1 0
26 27 1 0
27 28 1 0
28 29 1 0
29 30 1 0
30 31 1 0
31 32 1 0
32 33 1 0
33 34 1 0
34 35 1 0
35 36 1 0
36 37 1 0
37 38 1 0
38 39 1 0
39 40 1 0
40 41 1 0
41 42 1 0
42 43 1 0
43 44 1 0
44 45 1 0
45 46 1 0
46 47 1 0
47 48 1 0
48 49 1 0
49 50 1 0
50 51 1 0
51 52 1 0
52 53 1 0
53 54 1 0
54 55 1 0
55 56 1 0
56 57 1 0
57 58 1 0
58 59 1 0
59 60 1 0
60 61 1 0
61 62 1 0
62 63 1 0
63 64 1 0
64 65 1 0
65 66 1 0
66 67 1 0
67 68 1 0
68 69 1 0
69 70 1 0
70 71 1 0
71 72 1 0
72 73 1 0
73 74 1 0
74 75 1 0
75 76 1 0
76 77 1 0
77 78 1 0
78 79 1 0
79 80 1 0
80 81 1 0
81 82 1 0
82 83 1 0
83 84 1 0
84 85 1 0
85 86 1 0
86 87 1 0
87 88 1 0
88 89 1 0
89 90 1 0
90 91 1 0
91 92 1 0
92 93 1 0
93 94 1 0
94 95 1 0
95 96 1 0
96 97 1 0
97 98 1 0
98 99 1 0
99 100 1 0
101 102 1 0
